R 1280 720

NO ./data/textures/Texture_Bloc_01_64x64.XPM
EA ./data/textures/Texture_Bloc_01_64x64.XPM
SO ./data/textures/Texture_Bloc_01_64x64.XPM
WE ./data/textures/Texture_Bloc_07_64x64.XPM

S ./data/sprites/Soldier_Idle.xpm

F 255, 255, 0
C 50, 40, 64

111111
100001
100001
10N001
100001
111111
