111111
1N0101
102001
110001
111111
