11111
12021
10021
10001
10N01
11111
